E,E,E,E,E,E,E,E,E,E
E,E,0,E,E,0,0,0,0,E
0,0,0,G,0,0,0,0,0,E
0,0,E,0,0,E,0,0,0,E
0,E,E,E,0,0,0,0,0,E
E,E,E,E,E,E,0,0,0,E
0,0,G,0,0,E,0,0,0,E
